Chá de fita, Doce, LCD, droga, merda, Dólar na cueca, Thug Life, Turn down for what, FAZ O PULL

Bulbasaur = Dilmasauro
Ivysaur = Leninsaur
Venusaur = Marx-o-saur
	Specs: Doa o próprio item pra quem vai substituí-lo

Squirtle = Escroto
Wartortle = Wartorto
Blastoise = Blastranho
	Specs: Te deixa incomodado.

Charmander = Bixander, 
Charmeleon = Charmhilton
Charizard = Ayreszard
	Specs: Quando invocado, print("Hello, world!")

Hitmonlee = Impeachmonlee
Hitmontop = Impeachmontop
Hitmonchan = Impeachmonchan
	Specs: Quando entra em campo, subtitui o Inspermon adversário

Rattiti = Ratibike
Ratata = Ratinete
Raticate = Ratiskate
	Specs: 25, 50, 75% de chance a mais para tomar o 1o turno

Skarmory = Escárnio
	Specs: Abaixa defesa após desferir um poema de escárnio

Caterpie = Carapinha
Metapod = Meterpode
Butterfree = Manteiga Livre
	Specs: Textura: inflige dano extra ao receber dano

Dratini = Bolsomini
Dragonair = Bolsonair
Dragonite = Bolsomight

Nidoran F = Merkelran
Nidorina = Merkelrina
Nidoqueen = Merkelqueen 

Psyduck = Skafduck, Paulo Squack 
Golduck = O Pato, MBLduck
	Specs:  Nunca gasta poção, pq ele não vai pagar o pato

Seel = Selo
Dewgong = Inmetro

Electrike = Teslatrike
Manectric = Thomactric

Plusle = Rutherford
Minun = Thomson
"A ideia da descoberta das cargas elétricas"

Drowzee = Drowziu
Hypno = Hypnela

Lapras = Lepras

Magikarp = Magikratos, Manokarp
Gyarados = Manoirados

Mew = Neo (Matrix)
Mewtwo = NeoDois

Carvania = CarVânia
Sharpedo = Sharkinado

Totodile = Todos-os-Dados
Croconaw = Criminal
Feraligatr = Aligatorade, Feralicate

Girafarig = Girafariz

Wurmple = Rampou
Silcoon = Siliconha
Dustox = Detox

Lunatone = Lulatone
Sunrock = SenhorRock

Tropius = Trumpius

Cranidos = Crânios
Rampardos = Retardados

Cherubi = Chorume

Staravia = Lavavia
Staraptor = Lavajaptor

Finneon = Morfinneon
Lumineon = Crackineon

Probopass = Drop-the-Bass

Snorlax = Skrorllax
--------------------------------------------------------------------------------------------------------------------
							Referências
1-  "Quem nasceu pra Magikarp nunca vai ser Gyarados!"
2- Rebeca teve aula com o Bernardinho
3- "É hora de transmorfar!"
4- Faz o pull
5- No mundo mágico de UM PAÍS DA EUROPA um usuário inavisado adentra no mundo inóspito de LIVRO DO ROSTO e encontra
criaturas extremamente hostís e cheias de opiniões para dar
6- 